NO ./textures/bricks0.xpm
SO ./textures/bricks0.xpm
WE ./textures/bricks0.xpm
EA ./textures/bricks0.xpm

F 0, 0, 255
C 255, 487, 255            

111111111
100000001
100000001
100000001
100000001
1000S0001
100000001
100000001
100000001
111111111