NO          a
SO           b
WE                         s
EA d

C  32,                             31                                       ,                                              0
F  42,  45,1

        1111111111 1111111111111
        1000000000110000000000001111
        1001100000000000000000001
        10100000000000000000111111111111111               1
1111111100000111111110111111000000000000001              101
1000000000110000011101111111111111111111111               1
111101111111110111000000100011111
111101111111110111010100100011111
1100000011010101110001111110000001
100000000000S00111111000000100011111                     1111
1000000000000000110101001000111                          1001
1100000111010101111101111000111                          1111
11110111 1110101 101111010001
11111111 1111111 11111111111
