NO ./textures/N.xpm
SO ./textures/S.xpm
WE ./textures/W.xpm
EA ./textures/E.xpm

F 0, 0, 255
C  0, 255, 0

        1111111111 1111111111111
        1000000000110000000000001111
        1001100000000000000000001
        10100000000000000000111111111111111               1
1111111100000111111110111111000000000000001              101
1000000000110000011101111111111111111111111               1
111101111111110111000000100011111
111101111111110111010100100011111
1100S00011010101110001111110000001
100000000000000111111000000100011111                     111
1000000000000001101010010001111                          1001
1100000111010101111101111000111                          1111
11110111 1110101 101111010001
11111111 1111111 11111111111
