NO ./textures/bricks1.xpm
SO ./textures/bricks0.xpm
WE ./textures/bricks0.xpm
EA ./textures/bricks0.xpm

F 27, 36, 24
C  27, 0, 24

        1111111111 1111111111111
        1000000000110000000000001111
        1001100000000000000000001
        101000000000000000001111111111111111111111111111  1
11111111000001111111101111100000000000000000000000000001 101
10000000001100000111011111100111111111111111111111111111  1
111101111111110111000000100011111
1111011111111101110101001000111111
1100N00011010101110001111110000001
100000000000000111111000000100011111                     111
1000000000000001101010010001111                          1001
1100000111010101111101111000111                          1111
11110111 1110101 101111010001
11111111 1111111 11111111111
