NO          a
SO           b
WE                         s
EA d

C  32,                             31                                       ,                                              0
F  42,  45,1

        1111111111 1111111111111
        1000000000110000000000001111
        1001100000000000000000001
        101000000000000000000001111
111111110000011111111111111111
100000000011000001110111111111111
111101111111110111000000100011111
111101111111110111010100100011111
1100000011010101110001111110000001
100000000000S00011000000100011111
10000000000000001101010010001
1100000111010101111101111000111
11110111 1110101 101111010001
11111111 1111111 111111111111
