NO ./textures/N.xpm
SO ./textures/S.xpm
WE ./textures/W.xpm
EA ./textures/E.xpm
C 135,206,235
F 29,93,54


1111111
1000001
100000111
1001000011
100000000011111111111111111111111
100000000000000000000000000000N01
1000001111111111111111111111111111
1000001
1000001
1111111
